....................
....................
....................
....................
....................
....................
....................
....................
....................
....................
....................
....................
....................
.1..............S.H.
********************